America/Virgin	America/Port_of_Spain
America/Buenos_Aires	America/Argentina/Buenos_Aires
Africa/Maseru	Africa/Johannesburg
Etc/GMT+0	Etc/GMT
Australia/Yancowinna	Australia/Broken_Hill
Asia/Calcutta	Asia/Kolkata
Australia/South	Australia/Adelaide
US/Central	America/Chicago
Navajo	America/Denver
Europe/Skopje	Europe/Belgrade
Africa/Libreville	Africa/Lagos
America/Coral_Harbour	America/Atikokan
Africa/Freetown	Africa/Abidjan
America/St_Lucia	America/Port_of_Spain
Canada/Newfoundland	America/St_Johns
America/Montserrat	America/Port_of_Spain
PRC	Asia/Shanghai
US/Mountain	America/Denver
Asia/Thimbu	Asia/Thimphu
Africa/Blantyre	Africa/Maputo
Asia/Kashgar	Asia/Urumqi
America/Shiprock	America/Denver
Hongkong	Asia/Hong_Kong
America/Grenada	America/Port_of_Spain
Europe/Podgorica	Europe/Belgrade
Africa/Juba	Africa/Khartoum
Brazil/DeNoronha	America/Noronha
Jamaica	America/Jamaica
Arctic/Longyearbyen	Europe/Oslo
Europe/Guernsey	Europe/London
Africa/Kampala	Africa/Nairobi
GB	Europe/London
America/Aruba	America/Curacao
Chile/EasterIsland	Pacific/Easter
Etc/Universal	Etc/UTC
Africa/Dar_es_Salaam	Africa/Nairobi
America/Indianapolis	America/Indiana/Indianapolis
Pacific/Truk	Pacific/Chuuk
Canada/Mountain	America/Edmonton
Pacific/Yap	Pacific/Chuuk
Africa/Luanda	Africa/Lagos
America/Ensenada	America/Tijuana
Africa/Timbuktu	Africa/Abidjan
Universal	Etc/UTC
Turkey	Europe/Istanbul
America/Jujuy	America/Argentina/Jujuy
America/Cordoba	America/Argentina/Cordoba
Africa/Douala	Africa/Lagos
Asia/Harbin	Asia/Shanghai
Africa/Sao_Tome	Africa/Abidjan
America/Atka	America/Adak
Africa/Bujumbura	Africa/Maputo
America/Kralendijk	America/Curacao
Etc/GMT-0	Etc/GMT
Europe/Jersey	Europe/London
Europe/Nicosia	Asia/Nicosia
Asia/Macao	Asia/Macau
Australia/Canberra	Australia/Sydney
ROK	Asia/Seoul
US/Hawaii	Pacific/Honolulu
Asia/Ujung_Pandang	Asia/Makassar
Cuba	America/Havana
Asia/Saigon	Asia/Ho_Chi_Minh
ROC	Asia/Taipei
America/Louisville	America/Kentucky/Louisville
America/St_Barthelemy	America/Port_of_Spain
America/St_Thomas	America/Port_of_Spain
America/Porto_Acre	America/Rio_Branco
America/Rosario	America/Argentina/Cordoba
Europe/Belfast	Europe/London
America/Guadeloupe	America/Port_of_Spain
Australia/West	Australia/Perth
Brazil/West	America/Manaus
Libya	Africa/Tripoli
America/Fort_Wayne	America/Indiana/Indianapolis
Antarctica/McMurdo	Pacific/Auckland
Canada/Saskatchewan	America/Regina
Canada/Pacific	America/Vancouver
Canada/Eastern	America/Toronto
Iran	Asia/Tehran
GB-Eire	Europe/London
Etc/Greenwich	Etc/GMT
America/Catamarca	America/Argentina/Catamarca
Indian/Antananarivo	Africa/Nairobi
Europe/Sarajevo	Europe/Belgrade
America/St_Vincent	America/Port_of_Spain
US/Pacific	America/Los_Angeles
Portugal	Europe/Lisbon
Europe/Tiraspol	Europe/Chisinau
Europe/Busingen	Europe/Zurich
Asia/Katmandu	Asia/Kathmandu
Africa/Bamako	Africa/Abidjan
Etc/GMT0	Etc/GMT
Pacific/Ponape	Pacific/Pohnpei
Africa/Banjul	Africa/Abidjan
Japan	Asia/Tokyo
Africa/Ouagadougou	Africa/Abidjan
Kwajalein	Pacific/Kwajalein
Africa/Malabo	Africa/Lagos
America/Marigot	America/Port_of_Spain
America/Lower_Princes	America/Curacao
Greenwich	Etc/GMT
America/Mendoza	America/Argentina/Mendoza
Asia/Dacca	Asia/Dhaka
Africa/Djibouti	Africa/Nairobi
US/East-Indiana	America/Indiana/Indianapolis
America/Argentina/ComodRivadavia	America/Argentina/Catamarca
US/Michigan	America/Detroit
Canada/East-Saskatchewan	America/Regina
Chile/Continental	America/Santiago
Asia/Tel_Aviv	Asia/Jerusalem
Africa/Mbabane	Africa/Johannesburg
Mexico/General	America/Mexico_City
Asia/Istanbul	Europe/Istanbul
Europe/Isle_of_Man	Europe/London
GMT0	Etc/GMT
Europe/Mariehamn	Europe/Helsinki
Africa/Kinshasa	Africa/Lagos
Australia/Victoria	Australia/Melbourne
US/Aleutian	America/Adak
Australia/ACT	Australia/Sydney
Africa/Niamey	Africa/Lagos
Australia/North	Australia/Darwin
US/Samoa	Pacific/Pago_Pago
Africa/Nouakchott	Africa/Abidjan
Asia/Chungking	Asia/Shanghai
NZ	Pacific/Auckland
Asia/Ashkhabad	Asia/Ashgabat
Africa/Asmara	Africa/Nairobi
America/Knox_IN	America/Indiana/Knox
Atlantic/Jan_Mayen	Europe/Oslo
Zulu	Etc/UTC
Africa/Dakar	Africa/Abidjan
GMT+0	Etc/GMT
Africa/Mogadishu	Africa/Nairobi
Africa/Lusaka	Africa/Maputo
US/Eastern	America/New_York
Pacific/Samoa	Pacific/Pago_Pago
US/Indiana-Starke	America/Indiana/Knox
Africa/Addis_Ababa	Africa/Nairobi
Australia/LHI	Australia/Lord_Howe
Pacific/Johnston	Pacific/Honolulu
Asia/Vientiane	Asia/Bangkok
GMT	Etc/GMT
Canada/Yukon	America/Whitehorse
Africa/Conakry	Africa/Abidjan
Canada/Atlantic	America/Halifax
US/Arizona	America/Phoenix
Europe/San_Marino	Europe/Rome
Asia/Chongqing	Asia/Shanghai
Australia/NSW	Australia/Sydney
America/St_Kitts	America/Port_of_Spain
Brazil/East	America/Sao_Paulo
Africa/Harare	Africa/Maputo
US/Alaska	America/Anchorage
Etc/Zulu	Etc/UTC
Singapore	Asia/Singapore
Europe/Ljubljana	Europe/Belgrade
Indian/Mayotte	Africa/Nairobi
Asia/Phnom_Penh	Asia/Bangkok
Africa/Gaborone	Africa/Maputo
Atlantic/Faeroe	Atlantic/Faroe
Australia/Tasmania	Australia/Hobart
America/Anguilla	America/Port_of_Spain
Israel	Asia/Jerusalem
UCT	Etc/UCT
NZ-CHAT	Pacific/Chatham
Atlantic/St_Helena	Africa/Abidjan
Iceland	Atlantic/Reykjavik
Africa/Bangui	Africa/Lagos
Brazil/Acre	America/Rio_Branco
Europe/Vatican	Europe/Rome
Australia/Queensland	Australia/Brisbane
Poland	Europe/Warsaw
Africa/Lome	Africa/Abidjan
UTC	Etc/UTC
Mexico/BajaNorte	America/Tijuana
Africa/Kigali	Africa/Maputo
Eire	Europe/Dublin
Europe/Zagreb	Europe/Belgrade
Africa/Lubumbashi	Africa/Maputo
Africa/Brazzaville	Africa/Lagos
Mexico/BajaSur	America/Mazatlan
Europe/Bratislava	Europe/Prague
Canada/Central	America/Winnipeg
GMT-0	Etc/GMT
W-SU	Europe/Moscow
America/Dominica	America/Port_of_Spain
Egypt	Africa/Cairo
Africa/Porto-Novo	Africa/Lagos
America/Tortola	America/Port_of_Spain
Europe/Vaduz	Europe/Zurich
Antarctica/South_Pole	Pacific/Auckland
Asia/Ulan_Bator	Asia/Ulaanbaatar
Africa/Asmera	Africa/Asmara
Indian/Comoro	Africa/Nairobi